,Z,N,A,mass,lifetime
0,1,0,1,7288.9706,stbl
1,1,1,2,13135.7217,stbl
2,1,2,3,14949.8099,12.32   y 0.02
3,2,1,3,14931.2179,stbl
4,1,3,4,24620.0,139     ys 10
5,2,2,4,2424.9156,stbl
6,3,1,4,25320.0,91     ys 9
7,1,4,5,32890.0,>910     ys
8,2,3,5,11231.0,700     ys 30
9,3,2,5,11680.0,370     ys 30
10,1,5,6,41880.0,290     ys 70
11,2,4,6,17592.1,806.92  ms 0.24
12,3,3,6,14086.8789,stbl
13,4,2,6,18375.0,5.0   zs 0.3
14,2,5,7,26073.0,2.51  zs 0.07
15,3,4,7,14907.105,stbl
16,3,4,7,26150.0,11250      30
17,4,3,7,15769.0,53.22   d 0.06
18,4,3,7,26750.0,10980      30
19,5,2,7,27677.0,570     ys 14
20,2,6,8,31609.68,119.1   ms 1.2
21,3,5,8,20945.8,839.40  ms 0.36
22,3,5,8,31768.0,10822       5
23,4,4,8,4941.67,81.9   as 3.7
24,5,3,8,22921.6,770     ms 3
25,5,3,8,33546.0,10624       8
26,6,2,8,35064.0,3.5   zs 1.4
27,2,7,9,40940.0,2.5   zs 2.3
28,3,6,9,24954.9,178.3   ms 0.4
29,4,5,9,11348.45,stbl
30,5,4,9,12416.5,800     zs 300
31,6,3,9,28911.0,126.5   ms 0.9
32,2,8,10,49200.0,3.1   zs 2.0
33,3,7,10,33053.0,2.0   zs 0.5
34,3,7,10,33250.0,200      40
35,3,7,10,33530.0,480      40
36,4,6,10,12607.49,1.51  My 0.04
37,4,6,10,33787.0,21179      21
38,5,5,10,12050.609,stbl
39,6,4,10,15698.67,19.3009 s 0.0017
40,7,3,10,38800.0,200     ys 140
41,3,8,11,40728.3,8.75  ms 0.14
42,4,7,11,20177.17,13.76   s 0.07
43,4,7,11,41336.0,21158      20
44,5,6,11,8667.707,stbl
45,5,6,11,21228.0,12560       9
46,5,6,11,42230.0,33570      80     2
47,6,5,11,10649.4,20.364  m 0.014
48,6,5,11,22810.0,12160      40
49,7,4,11,24300.0,550     ys 20
50,3,9,12,49010.0,<10     ns                      00
51,4,8,12,25077.8,21.50  ms 0.04
52,5,7,12,13369.4,20.20  ms 0.02
53,5,7,12,26088.0,12719      19
54,6,6,12,0.0,stbl
55,6,6,12,15108.0,15108       3
56,7,5,12,17338.1,11.000 ms 0.016
57,7,5,12,29534.0,12195      29     2
58,8,4,12,31915.0,>6.3   zs        0
59,3,10,13,56980.0,3.3   zs 1.2
60,4,9,13,33659.0,1.0   zs 0.7
61,4,9,13,35160.0,1500      50
62,5,8,13,16561.9,17.33  ms 0.17
63,6,7,13,3125.0088,stbl
64,7,6,13,5345.48,9.965  m 0.004
65,8,5,13,23115.0,8.58  ms 0.05
66,4,10,14,39950.0,4.35  ms 0.17
67,4,10,14,41470.0,1520     150
68,5,9,14,23664.0,12.5   ms 0.5
69,5,9,14,40728.0,17065      29
70,6,8,14,3019.893,5.70  ky 0.03
71,7,7,14,2863.4167,stbl
72,8,6,14,8007.781,70.620  s 0.013
73,9,5,14,31960.0,500     ys 60
74,4,11,15,49830.0,790     ys 270
75,5,10,15,28958.0,9.93  ms 0.07
76,6,9,15,9873.1,2.449  s 0.005
77,7,8,15,101.4387,stbl
78,7,8,15,11717.0,11615       4
79,8,7,15,2855.6,122.24   s 0.16
80,9,6,15,16567.0,1.1   zs 0.3
81,4,12,16,57450.0,650     ys 130
82,5,11,16,37113.0,>4.6   zs        0
83,6,10,16,13694.0,747     ms 8
84,7,9,16,5683.9,7.13   s 0.02
85,7,9,16,15613.0,9929       7
86,8,8,16,8059.0,12796       4
87,8,8,16,17984.0,22721       4
88,9,7,16,10680.0,11     zs 6
89,10,6,16,23987.0,>5.7   zs        0
90,5,12,17,43720.0,5.08  ms 0.05
91,6,11,17,21032.0,193     ms 5
92,7,10,17,7870.0,4.173  s 0.004
93,9,8,17,1951.7,64.370  s 0.027
94,10,7,17,16500.4,109.2   ms 0.6
95,5,13,18,51790.0,<26     ns
96,6,12,18,24920.0,92     ms 2
97,7,11,18,13113.0,619.2   ms 1.9
98,9,9,18,873.1,109.739  m 0.009
99,10,8,18,5317.6,1664.20  ms 0.47
100,11,7,18,25040.0,1.3   zs 0.4
101,5,14,19,59770.0,2.92  ms 0.13
102,6,13,19,32410.0,46.2   ms 2.3
103,7,12,19,15856.0,336     ms 3
104,8,11,19,3332.9,26.470  s 0.006
105,10,9,19,1752.05,17.274  s 0.010
106,10,9,19,9253.0,7501       9
107,11,8,19,12929.0,>1     as
108,12,7,19,31830.0,5     ps 3
109,6,14,20,37500.0,16     ms 3
110,7,13,20,21770.0,136     ms 3
111,8,12,20,3796.2,13.51   s 0.05
112,9,11,20,6503.0,6521       3
113,11,9,20,6850.6,447.9   ms 2.3
114,12,8,20,17477.7,93     ms 5
115,7,14,21,25230.0,84     ms 7
116,8,13,21,8062.0,3.42   s 0.10
117,11,10,21,6790.0,8975       4
118,12,9,21,10903.8,118.6   ms 0.5
119,6,16,22,53610.0,6.2   ms 1.3
120,7,15,22,31760.0,23     ms 3
121,8,14,22,9280.0,2.25   s 0.09
122,9,13,22,2793.0,4.23   s 0.04
123,12,10,22,13645.0,14044       6
124,13,9,22,18200.0,91.1   ms 0.5
125,14,8,22,33340.0,29     ms 2
126,7,16,23,36720.0,13.9   ms 1.4
127,8,15,23,14620.0,97     ms 8
128,9,14,23,3290.0,2.23   s 0.14
129,13,10,23,6748.1,470     ms 30
130,13,10,23,18530.0,11780      60
131,14,9,23,23700.0,42.3   ms 0.4
132,8,16,24,18500.0,77.4   ms 4.5
133,9,15,24,7540.0,384     ms 16
134,13,11,24,5900.0,5949       3
135,14,10,24,10745.0,140     ms 8
136,8,17,25,27330.0,5.18  zs 0.35
137,9,16,25,11330.0,80     ms 9
138,14,11,25,3827.0,220     ms 3
139,8,18,26,34660.0,4.2   ps 3.3
140,9,17,26,18650.0,8.2   ms 0.9
141,10,16,26,481.0,197     ms 2
142,14,12,26,5926.0,13068      11
143,15,11,26,10970.0,43.7   ms 0.6
144,9,18,27,25450.0,4.9   ms 0.2
145,10,17,27,7050.0,31.5   ms 1.3
146,15,12,27,12010.0,12730      40
147,16,11,27,17030.0,15.5   ms 1.5
148,9,19,28,33740.0,46     zs                      13
149,10,18,28,11300.0,20     ms 1
150,16,12,28,4070.0,125     ms 10
151,9,20,29,40150.0,2.5   ms 0.3
152,10,19,29,18400.0,14.7   ms 0.4
153,11,18,29,2680.0,44.1   ms 0.9
154,10,20,30,23280.0,7.22  ms 0.18
155,11,19,30,8475.0,48.4   ms 1.7
156,10,21,31,31180.0,3.4   ms 0.8
157,11,20,31,12246.0,17.35  ms 0.40
158,17,14,31,5256.0,12291       5
159,18,13,31,11330.0,15.1   ms 0.3
160,10,22,32,37000.0,3.5   ms 0.9
161,11,21,32,18640.0,12.9   ms 0.3
162,11,22,33,23780.0,8.2   ms 0.4
163,12,21,33,4962.3,90.5   ms 1.6
164,11,23,34,31680.0,5.5   ms 1.0
165,12,22,34,8323.0,20     ms 10
166,11,24,35,38230.0,1.5   ms 0.5
167,12,23,35,15640.0,70     ms 40
168,20,15,35,4790.0,25.7   ms 0.2
169,12,24,36,20380.0,3.9   ms 1.3
170,13,23,36,5950.0,90     ms 40
171,12,25,37,28210.0,8     ms 4
172,13,24,37,9810.0,11.5   ms 0.4
173,13,25,38,16210.0,9.0   ms 0.7
174,13,26,39,20650.0,7.6   ms 1.6
175,14,25,39,2320.0,47.5   ms 2.0
176,22,17,39,2200.0,28.5   ms 0.9
177,14,26,40,5430.0,33.0   ms 1.0
178,14,27,41,12120.0,20.0   ms 2.5
179,14,28,42,16470.0,12.5   ms 3.5
180,15,27,42,1010.0,48.5   ms 1.5
181,24,18,42,6730.0,13.3   ms 1.0
182,15,28,43,4680.0,35.8   ms 1.3
183,15,29,44,10450.0,18.5   ms 2.5
184,26,19,45,13760.0,2.2   ms 0.3
185,16,30,46,340.0,50     ms 8
186,26,20,46,910.0,13.0   ms 2.0
187,28,20,48,16790.0,2.8   ms 0.8
188,28,21,49,8200.0,7.5   ms 1.0
189,80,91,171,3480.0,70     us 30
190,81,95,176,580.0,6.2   ms 2.3
191,82,96,178,3574.0,230     us 150
192,82,97,179,2050.0,3.9   ms 1.1
193,84,102,186,4101.0,34     us 12
194,84,103,187,2830.0,4      27
195,85,106,191,3864.0,2.1   ms 0.8
196,85,106,191,3922.0,58      20
197,85,107,192,2926.0,0      40
198,86,107,193,9043.0,1.15  ms 0.27
199,86,108,194,5723.0,780     us 160
200,86,109,195,5131.0,80      50
201,86,110,196,1971.0,4.7   ms 1.1
202,86,111,197,1510.0,54     ms 6
203,86,111,197,1709.0,199      11           25.6
204,87,110,197,10250.0,2.33  ms 1.88
205,87,111,198,9570.0,15     ms 3
206,87,111,198,9580.0,0      50            1.1
207,87,112,199,6771.0,6.6   ms 2.2
208,87,112,199,6817.0,45      13
209,87,113,200,6180.0,50      60
210,87,114,201,3589.0,62.8   ms 1.9
211,87,114,201,3715.0,127      11
212,88,113,201,11937.0,20     ms 30
213,88,113,201,12200.0,263      26            6
214,87,115,202,3096.0,372     ms 12
215,87,115,202,3370.0,274      12
216,88,114,202,9075.0,4.1   ms 1.1
217,87,116,203,876.0,550     ms 10
218,87,116,203,1237.0,361       6           43
219,88,115,203,8660.0,36     ms 13
220,88,115,203,8851.0,190      50
221,87,117,204,607.0,1.75   s 0.26
222,87,117,204,658.0,50       4
223,87,117,204,934.0,326       4
224,88,116,204,6057.0,60     ms 9
225,88,117,205,5840.0,220     ms 50
226,89,116,205,14110.0,80     ms 60
227,88,118,206,3566.0,240     ms 20
228,89,117,206,13480.0,25     ms 7
229,89,117,206,13700.0,220      60
230,88,119,207,3540.0,1.38   s 0.18
231,88,119,207,4102.0,560      50
232,89,118,207,11150.0,31     ms 8
233,88,120,208,1728.0,1.110  s 0.045
234,89,119,208,10750.0,97     ms 15
235,89,119,208,11258.0,500      50
236,90,118,208,16680.0,2.4   ms 1.2
237,88,121,209,1858.0,4.71   s 0.08
238,89,120,209,8840.0,94     ms 10
239,88,122,210,443.0,4.0    s 0.1
240,89,121,210,8790.0,350     ms 40
241,90,120,210,14059.0,16.0   ms 3.6
242,88,123,211,832.0,13.2    s 1.4
243,89,122,211,7200.0,213     ms 25
244,90,121,211,13910.0,48     ms 20
245,89,123,212,7280.0,895     ms 28
246,90,122,212,12111.0,31.7   ms 1.3
247,91,121,212,21590.0,7.5   ms 2.8
248,81,132,213,1784.0,24      s 4
249,88,125,213,346.0,2.73   m 0.05
250,88,125,213,2114.0,1768       4
251,89,124,213,6155.0,738     ms 16
252,90,123,213,12120.0,144     ms 21
253,91,122,213,19660.0,7     ms 3
254,81,133,214,6470.0,11      s 2
255,88,126,214,93.0,2.437  s 0.016
256,89,125,214,6444.0,8.2    s 0.2
257,90,124,214,10695.0,87     ms 10
258,91,123,214,19490.0,17     ms 3
259,81,134,215,9910.0,10      s 4
260,82,133,215,4340.0,2.34   m 0.19
261,83,132,215,1629.0,7.6    m 0.2
262,87,128,215,318.0,86     ns 5
263,88,127,215,2534.0,1.67  ms 0.01
264,89,126,215,6031.0,170     ms 10
265,90,125,215,10922.0,1.2    s 0.2
266,91,124,215,17860.0,14     ms 2
267,92,123,215,24920.0,1.4   ms 0.9
268,81,135,216,14720.0,6      s 3
269,82,134,216,7480.0,1.65   m 0.2
270,83,133,216,5898.0,24      19
271,84,132,216,1782.4,145     ms 2
272,85,131,216,2257.0,300     us 30
273,85,131,216,2417.0,161      11
274,86,130,216,253.0,45     us 5
275,87,129,216,2971.0,700     ns 20
276,87,129,216,3190.0,219       6
277,88,128,216,3291.0,182     ns 10
278,89,127,216,8144.0,440     us 16
279,89,127,216,8188.0,44       8
280,90,126,216,10298.0,26.0   ms 0.2
281,90,126,216,12342.0,2043       9
282,91,125,216,17800.0,105     ms 12
283,92,124,216,23066.0,6.9   ms 2.9
284,92,124,216,25320.0,2250      40            1.4
285,82,135,217,12240.0,20      s 5
286,83,134,217,8730.0,98.5    s 1.3
287,84,133,217,5884.0,1.514  s 0.026
288,85,132,217,4395.0,32.62  ms 0.24
289,86,131,217,3659.0,540     us 50
290,87,130,217,4315.0,16.8   us 1.9
291,88,129,217,5890.0,1.63  us 0.17
292,89,128,217,8704.0,69     ns 4
293,89,128,217,10716.0,2012      20
294,90,127,217,12206.0,247     us 4
295,91,126,217,17068.0,3.48  ms 0.09
296,91,126,217,18929.0,1860       7
297,92,125,217,22970.0,800     us 700
298,82,136,218,15450.0,15      s 7
299,83,135,218,13216.0,33      s 1
300,84,134,218,8356.9,3.098  m 0.012
301,85,133,218,8098.0,1.5    s 0.3
302,86,132,218,5217.3,33.75  ms 0.15
303,87,131,218,7059.0,1.0   ms 0.6
304,87,131,218,7146.0,86       4
305,88,130,218,6651.0,25.2   us 0.3
306,89,129,218,10840.0,1.00  us 0.04
307,90,128,218,12367.0,117     ns 9
308,91,127,218,18684.0,113     us 10
309,92,126,218,21895.0,550     us 140
310,92,126,218,24004.0,2109      17
311,83,136,219,16280.0,8.7    s 2.9
312,84,135,219,12681.0,10.3    m 1.0
313,85,134,219,10396.0,56      s 3
314,86,133,219,8829.4,3.96   s 0.01
315,87,132,219,8618.0,20     ms 2
316,88,131,219,9394.0,10     ms 3
317,89,130,219,11570.0,11.8   us 1.5
318,90,129,219,14470.0,1.021 us 0.024
319,91,128,219,18540.0,53     ns 10
320,92,127,219,23290.0,55     us 25
321,93,126,219,29460.0,<5     us        9
322,83,137,220,20820.0,9.5    s 5.7
323,85,135,220,14376.0,3.71   m 0.04
324,86,134,220,10612.1,55.6    s 0.1
325,87,133,220,11482.0,27.4    s 0.3
326,88,132,220,10270.0,17.9   ms 1.4
327,89,131,220,13744.0,26.36  ms 0.19
328,90,130,220,14669.0,9.7   us 0.6
329,91,129,220,20220.0,780     ns 160
330,84,137,221,19774.0,2.2    m 0.7
331,85,136,221,16783.0,2.3    m 0.2
332,86,135,221,14471.0,25.7    m 0.5
333,87,134,221,13277.0,4.801  m 0.005
334,88,133,221,12964.0,28      s 2
335,89,132,221,14520.0,52     ms 2
336,90,131,221,16940.0,1.78  ms 0.03
337,91,130,221,20380.0,5.9   us 1.7
338,92,129,221,24520.0,660     ns 140
339,84,138,222,22490.0,9.1    m 7.2
340,85,137,222,20953.0,54      s 10
341,86,136,222,16372.2,3.8215 d 0.0002
342,87,135,222,16378.0,14.2    m 0.3
343,88,134,222,14320.0,33.6    s 0.4
344,90,132,222,17203.0,2.24  ms 0.03
345,91,131,222,22160.0,3.2   ms 0.3
346,92,130,222,24270.0,4.7   us 0.7
347,85,138,223,23428.0,50      s 7
348,86,137,223,20390.0,24.3    m 0.4
349,87,136,223,18382.4,22.00   m 0.07
350,88,135,223,17233.3,11.4377 d 0.0022
351,89,134,223,17826.0,2.10   m 0.05
352,90,133,223,19386.0,600     ms 20
353,91,132,223,22320.0,5.1   ms 0.3
354,92,131,223,25840.0,21     us 8
355,85,139,224,27711.0,2.5    m 1.5
356,86,138,224,22445.0,107      m 3
357,87,137,224,21749.0,3.33   m 0.10
358,88,136,224,18825.9,3.6319 d 0.0023
359,89,135,224,20234.0,2.78   h 0.16
360,90,134,224,19994.0,1.04   s 0.02
361,91,133,224,23862.0,846     ms 20
362,92,132,224,25722.0,396     us 17
363,86,139,225,26534.0,4.66   m 0.04
364,87,138,225,23821.0,3.95   m 0.14
365,88,137,225,21993.1,14.9    d 0.2
366,89,136,225,21637.0,9.920  d 0.003
367,90,135,225,22310.0,8.75   m 0.04
368,91,134,225,24340.0,1.7    s 0.2
369,92,133,225,27380.0,61     ms 4
370,93,132,225,31590.0,6     ms 5
371,86,140,226,28747.0,7.4    m 0.1
372,87,139,226,27521.0,49      s 1
373,88,138,226,23667.8,1.600 ky 0.007
374,89,137,226,24309.0,29.37   h 0.12
375,90,136,226,23198.0,30.70   m 0.03
376,91,135,226,26033.0,1.8    m 0.2
377,92,134,226,27329.0,269     ms 6
378,93,133,226,32780.0,35     ms 10
379,86,141,227,32886.0,20.2    s 0.4
380,87,140,227,29682.0,2.47   m 0.03
381,88,139,227,27177.7,42.2    m 0.5
382,89,138,227,25849.6,21.772  y 0.003
383,90,137,227,25804.8,18.697  d 0.007
384,91,136,227,26831.0,38.3    m 0.3
385,92,135,227,29045.0,1.1    m 0.1
386,93,134,227,32560.0,510     ms 60
387,86,142,228,35243.0,65      s 2
388,87,141,228,33384.0,38      s 1
389,88,140,228,28940.3,5.75   y 0.03
390,89,139,228,28894.7,6.15   h 0.02
391,90,138,228,26771.0,1.9124 y 0.0008
392,91,137,228,28924.0,22      h 1
393,92,136,228,29222.0,9.1    m 0.2
394,93,135,228,33600.0,61.4    s 1.4
395,94,134,228,36087.0,2.1    s 1.3
396,86,143,229,39362.0,11.9    s 1.3
397,87,142,229,35668.0,50.2    s 0.4
398,88,141,229,32562.0,4.0    m 0.2
399,89,140,229,30690.0,62.7    m 0.5
400,90,139,229,29585.6,7.920 ky 0.017
401,91,138,229,29897.0,1.50   d 0.05
402,92,137,229,31211.0,57.8    m 0.5
403,93,136,229,33780.0,4.00   m 0.18
404,94,135,229,37400.0,91      s 26
405,95,134,229,42150.0,1.8    s 1.5
406,87,143,230,39487.0,19.1    s 0.5
407,88,142,230,34516.0,93      m 2
408,89,141,230,33838.0,122      s 3
409,90,140,230,30862.6,75.4   ky 0.3
410,91,139,230,32174.0,17.4    d 0.5
411,92,138,230,31615.0,20.23   d 0.02
412,93,137,230,35240.0,4.6    m 0.3
413,94,136,230,36934.0,1.70   m 0.17
414,95,135,230,42930.0,40      s 16
415,87,144,231,42081.0,17.6    s 0.6
416,88,143,231,38216.0,104      s 1
417,89,142,231,35763.0,7.5    m 0.1
418,90,141,231,33815.9,25.52   h 0.01
419,91,140,231,33424.4,32.76  ky 0.11
420,92,139,231,33806.0,4.2    d 0.1
421,93,138,231,35620.0,48.8    m 0.2
422,94,137,231,38309.0,8.6    m 0.5
423,87,145,232,46073.0,5.5    s 0.6
424,88,144,232,40497.0,4.0    m 0.3
425,89,143,232,39154.0,1.98   m 0.08
426,90,142,232,35446.8,14.0   Gy 0.1
427,91,141,232,35947.0,1.32   d 0.02
428,92,140,232,34609.5,68.9    y 0.4
429,93,139,232,37360.0,14.7    m 0.3
430,94,138,232,38363.0,33.7    m 0.5
431,95,137,232,43340.0,1.31   m 0.04
432,87,146,233,48920.0,900     ms 100
433,88,145,233,44334.0,30      s 5
434,89,144,233,41308.0,145      s 10
435,90,143,233,38731.7,21.83   m 0.04
436,91,142,233,37489.5,26.975  d 0.013
437,92,141,233,36919.2,159.2   ky 0.2
438,93,140,233,37950.0,36.2    m 0.1
439,94,139,233,40050.0,20.9    m 0.4
440,95,138,233,43260.0,3.2    m 0.8
441,96,137,233,47290.0,27      s 10
442,97,136,233,52860.0,40      s 30
443,88,146,234,46931.0,30      s 10
444,89,145,234,44841.0,45      s 2
445,90,144,234,40613.0,24.10   d 0.03
446,91,143,234,40339.0,6.70   h 0.05
447,91,143,234,40417.9,79       3
448,92,142,234,38145.0,245.5   ky 0.6
449,93,141,234,39955.0,4.4    d 0.1
450,94,140,234,40350.0,8.8    h 0.1
451,95,139,234,44460.0,2.32   m 0.08
452,96,138,234,46725.0,52      s 9
453,97,137,234,53460.0,20      s 5
454,89,146,235,47357.0,62      s 4
455,90,145,235,44018.0,7.2    m 0.1
456,91,144,235,42289.0,24.4    m 0.2
457,92,143,235,40918.8,704     My 1
458,93,142,235,41043.1,396.1    d 1.2
459,94,141,235,42182.0,25.3    m 0.5
460,95,140,235,44630.0,10.3    m 0.6
461,89,147,236,51220.0,4.5    m 3.6
462,90,146,236,46255.0,37.3    m 1.5
463,91,145,236,45334.0,9.1    m 0.1
464,92,144,236,42444.6,23.42  My 0.03
465,93,143,236,43438.0,60      50
466,93,143,236,43616.0,240      50
467,94,142,236,42901.6,2.858  y 0.008
468,95,141,236,46040.0,3.6    m 0.1
469,96,140,236,47855.0,6.8    m 0.8
470,90,147,237,49955.0,4.8    m 0.5
471,91,146,237,47528.0,8.7    m 0.2
472,92,145,237,45390.2,6.752  d 0.002
473,93,144,237,44871.7,2.144 My 0.007
474,94,143,237,45091.7,45.64   d 0.04
475,95,142,237,46570.0,73.6    m 0.8
476,98,139,237,57940.0,0.8    s 0.2
477,90,148,238,52530.0,9.4    m 2.0
478,91,147,238,50894.0,2.28   m 0.09
479,92,146,238,47307.8,4.468 Gy 0.006
480,93,145,238,47454.7,2.099  d 0.002
481,94,144,238,46163.2,87.7    y 0.1
482,95,143,238,48420.0,98      m 2
483,96,142,238,49445.0,2.2    h 0.4
484,97,141,238,54220.0,2.40   m 0.08
485,98,140,238,57280.0,21.1   ms 1.3
486,91,148,239,53340.0,1.8    h 0.5
487,92,147,239,50572.7,23.45   m 0.02
488,93,146,239,49311.1,2.356  d 0.003
489,94,145,239,48588.3,24.11  ky 0.03
490,95,144,239,49390.4,11.9    h 0.1
491,96,143,239,51150.0,2.5    h 0.4
492,97,142,239,54290.0,41      11
493,98,141,239,58270.0,60      s 30
494,92,148,240,52715.5,14.1    h 0.1
495,93,147,240,52334.0,18      14
496,94,146,240,50125.4,6.561 ky 0.007
497,95,145,240,51510.0,50.8    h 0.3
498,96,144,240,51724.3,27      d 1
499,97,143,240,55660.0,4.8    m 0.8
500,98,142,240,57991.0,40.3    s 0.9
501,93,148,241,54260.0,13.9    m 0.2
502,94,147,241,52955.2,14.329  y 0.029
503,95,146,241,52934.4,432.6    y 0.6
504,96,145,241,53701.8,32.8    d 0.2
505,97,144,241,56030.0,4.6    m 0.4
506,97,144,241,56080.0,51       3
507,98,143,241,59330.0,2.35   m 0.18
508,99,142,241,63860.0,10      s 5
509,100,141,241,69130.0,730     us 60
510,92,150,242,58620.0,16.8    m 0.5
511,94,148,242,54716.9,375     ky 2
512,95,147,242,55468.1,16.02   h 0.02
513,96,146,242,54803.8,162.8    d 0.2
514,97,145,242,57730.0,7.0    m 1.3
515,98,144,242,59387.0,3.49   m 0.15
516,99,143,242,64800.0,17.8    s 1.6
517,100,142,242,68400.0,800     us 200
518,93,150,243,59880.0,1.85   m 0.15
519,94,149,243,57754.6,4.956  h 0.003
520,95,148,243,57175.0,7.364 ky 0.022
521,96,147,243,57182.0,29.1    y 0.1
522,96,147,243,57279.0,97      16
523,97,146,243,58690.0,4.6    h 0.2
524,97,146,243,58710.0,20      20
525,98,145,243,60990.0,10.7    m 0.5
526,99,144,243,64750.0,21.6    s 1.6
527,100,143,243,69390.0,231     ms 9
528,93,151,244,63200.0,2.29   m 0.16
529,94,150,244,59806.0,80.0   My 0.9
530,95,149,244,59879.2,10.1    h 0.1
531,96,148,244,58451.9,18.10   y 0.02
532,97,147,244,60714.0,5.02   h 0.03
533,98,146,244,61478.2,19.4    m 0.6
534,99,145,244,66030.0,37      s 4
535,100,144,244,68970.0,3.12  ms 0.08
536,94,151,245,63178.0,10.5    h 0.1
537,95,150,245,61900.5,2.05   h 0.01
538,96,149,245,61004.6,8.25  ky 0.07
539,97,148,245,61813.8,4.95   d 0.03
540,98,147,245,63385.2,45.0    m 1.5
541,99,146,245,66370.0,1.1    m 0.1
542,99,146,245,66650.0,283      15
543,100,145,245,70190.0,4.2    s 1.3
544,94,152,246,65395.0,10.84   d 0.02
545,95,151,246,64994.0,39      m 3
546,96,150,246,62617.0,4.706 ky 0.040
547,97,149,246,63970.0,1.80   d 0.02
548,98,148,246,64090.3,35.7    h 0.5
549,99,147,246,67900.0,7.5    m 0.5
550,100,146,246,70189.0,1.54   s 0.04
551,101,145,246,76120.0,0.92   s 0.18
552,101,145,246,76170.0,60      60
553,94,153,247,69110.0,2.27   d 0.23
554,95,152,247,67150.0,23.0    m 1.3
555,96,151,247,65533.0,15.6   My 0.5
556,97,150,247,65490.0,1.38  ky 0.25
557,98,149,247,66104.0,3.11   h 0.03
558,99,148,247,68578.0,4.55   m 0.26
559,100,147,247,71670.0,31      s 1
560,100,147,247,71720.0,49       8
561,101,146,247,75940.0,1.2    s 0.1
562,101,146,247,76200.0,260      40
563,96,152,248,67392.8,348     ky 6
564,98,150,248,67238.0,333.5    d 2.8
565,99,149,248,70300.0,24      m 3
566,100,148,248,71898.0,34.5    s 1.2
567,101,147,248,77150.0,7      s 3
568,96,153,249,70750.7,64.15   m 0.03
569,97,152,249,69846.4,327.2    d 0.3
570,98,151,249,69722.8,351      y 2
571,99,150,249,71180.0,102.2    m 0.6
572,100,149,249,73519.0,1.6    m 0.1
573,101,148,249,77230.0,23.4    s 2.4
574,102,147,249,81780.0,57     us 12
575,97,153,250,72950.0,3.212  h 0.005
576,98,152,250,71170.4,13.08   y 0.09
577,100,150,250,74072.0,30.4    m 1.5
578,101,149,250,78630.0,52      s 5
579,102,148,250,81560.0,5.0   us 0.6
580,96,155,251,76648.0,16.8    m 0.2
581,97,154,251,75228.0,55.6    m 1.1
582,98,153,251,74135.0,900      y 40
583,99,152,251,74512.0,33      h 1
584,100,151,251,75954.0,5.30   h 0.08
585,101,150,251,78967.0,4.21   m 0.23
586,101,150,251,79020.0,53       8
587,102,149,251,82850.0,800     ms 10
588,102,149,251,82960.0,106       6
589,97,155,252,78540.0,1.8    m 0.5
590,98,154,252,76034.6,2.645  y 0.008
591,99,153,252,77290.0,471.7    d 1.9
592,100,152,252,76816.0,25.39   h 0.04
593,101,151,252,80510.0,2.3    m 0.8
594,102,150,252,82871.0,2.45   s 0.02
595,103,149,252,88740.0,369     ms 75
596,103,149,252,88910.0,170      30
597,98,155,253,79302.0,17.81   d 0.08
598,99,154,253,79010.5,20.47   d 0.03
599,100,153,253,79345.7,3.00   d 0.12
600,101,152,253,81170.0,12      m 8
601,101,152,253,81230.0,60      30                            1
602,102,151,253,84359.0,1.56   m 0.02
603,98,156,254,81341.0,60.5    d 0.2
604,99,155,254,81991.0,275.7    d 0.5
605,100,154,254,80902.8,3.240  h 0.002
606,102,152,254,84723.0,51.2    s 0.4
607,103,151,254,89870.0,17.1    s 1.8
608,103,151,254,89940.0,60      50
609,104,150,254,93200.0,23.2   us 1.0
610,98,157,255,84810.0,85      m 18
611,99,156,255,84089.0,39.8    d 1.2
612,100,155,255,83800.0,20.07   h 0.07
613,101,154,255,84843.0,27      m 2
614,102,153,255,86807.0,3.52   m 0.18
615,103,152,255,89947.0,31.1    s 1.1
616,103,152,255,89988.0,41       8
617,104,151,255,94330.0,1.66   s 0.07
618,104,151,255,94480.0,150      22
619,105,150,255,99590.0,1.7    s 0.5
620,98,158,256,87040.0,12.3    m 1.2
621,100,156,256,85487.0,157.6    m 1.3
622,102,154,256,87822.0,2.91   s 0.05
623,103,153,256,91750.0,27      s 3
624,104,152,256,94222.0,6.67  ms 0.10
625,105,151,256,100500.0,1.7    s 0.4
626,99,158,257,89400.0,7.7    d 0.2
627,100,157,257,88590.0,100.5    d 0.2
628,101,156,257,88993.1,5.52   h 0.05
629,102,155,257,90247.0,24.5    s 0.5
630,103,154,257,92670.0,6.0    s 0.4
631,104,153,257,95866.0,4.82   s 0.13
632,104,153,257,95940.0,73      11
633,104,153,257,97022.0,1155      11
634,100,158,258,90430.0,370     us 14
635,102,156,258,91480.0,1.2   ms 0.2
636,103,155,258,94780.0,3.6    s 0.4
637,104,154,258,96340.0,13.8   ms 0.9
638,106,152,258,105240.0,2.7   ms 0.5
639,100,159,259,93700.0,1.5    s 0.2
640,101,158,259,93620.0,1.60   h 0.06
641,102,157,259,94079.0,58      m 5
642,103,156,259,95850.0,6.2    s 0.3
643,104,155,259,98360.0,2.63   s 0.26
644,104,155,259,98430.0,60      70
645,104,155,259,98570.0,210      90
646,105,154,259,101990.0,510     ms 160
647,106,153,259,106520.0,402     ms 56
648,106,153,259,106610.0,87      22
649,101,159,260,96550.0,27.8    d 0.8
650,102,158,260,95610.0,106     ms 8
651,103,157,260,98280.0,3.0    m 0.5
652,104,156,260,99150.0,21     ms 1
653,105,155,260,103670.0,1.52   s 0.13
654,106,154,260,106548.0,4.95  ms 0.33
655,107,153,260,113320.0,41     ms 14
656,103,158,261,99560.0,39      m 12
657,105,156,261,104310.0,4.7    s 1.0
658,106,155,261,108005.0,183     ms 5
659,107,154,261,113130.0,12.8   ms 3.2
660,102,160,262,100100.0,~5     ms        0
661,103,159,262,102100.0,~4      h                      01
662,105,157,262,106250.0,34      s 4
663,106,156,262,108370.0,10.9   ms 2.3
664,106,156,262,109220.0,860      90
665,107,155,262,114540.0,84     ms 11
666,107,155,262,114760.0,210      50
667,104,159,263,104760.0,11      m 3
668,105,158,263,107110.0,29      s 9
669,106,157,263,110240.0,51      19
670,106,157,263,110290.0,100      30
671,108,155,263,119680.0,760     us 40
672,108,155,263,120000.0,320      70
673,106,158,264,110780.0,47     ms 20
674,107,157,264,116060.0,1.07   s 0.21
675,108,156,264,119563.0,540     us 300
676,104,161,265,108690.0,1.6    m 0.8
677,107,158,265,116420.0,1.19   s 0.52
678,108,157,265,120900.0,1.96  ms 0.16
679,108,157,265,121130.0,229      22
680,103,163,266,111620.0,21      h 14
681,105,161,266,112740.0,80      m 70
682,106,160,266,113620.0,390     ms 110
683,107,159,266,118100.0,2.5    s 1.6
684,108,158,266,121140.0,3.02  ms 0.54
685,108,158,266,122240.0,1100      70
686,109,157,266,127960.0,1.2   ms 0.4
687,109,157,266,129100.0,1140      80
688,104,163,267,113440.0,2.5    h 1.5
689,105,162,267,114070.0,100      m 60
690,106,161,267,115810.0,1.8    m 0.7
691,107,160,267,118770.0,22      s 10
692,108,159,267,122650.0,55     ms 11
693,108,159,267,122690.0,39      24
694,110,157,267,133880.0,10     us 8
695,105,163,268,117060.0,29      h 4
696,105,163,268,117210.0,150      70
697,108,160,268,122830.0,1.42   s 1.13
698,109,159,268,129150.0,27     ms 6
699,106,163,269,119760.0,5      m 3
700,108,161,269,124560.0,16      s 6
701,110,159,269,134830.0,230     us 110
702,105,165,270,122310.0,2.0    h 1.3
703,107,163,270,124230.0,3.8    m 3.0
704,108,162,270,125110.0,9      s 4
705,109,161,270,130710.0,6.3   ms 1.5
706,110,160,270,134680.0,205     us 48
707,110,160,270,136070.0,1390      60
708,106,165,271,124760.0,3.1    m 1.6
709,107,164,271,125920.0,10      m 8
710,110,161,271,136020.0,68      27
711,107,165,272,128790.0,11.3    s 1.8
712,111,161,272,142770.0,4.5   ms 1.0
713,108,165,273,131890.0,1060     ms 500
714,110,163,273,138360.0,240     us 80
715,107,167,274,133680.0,60      s 30
716,109,165,274,137250.0,850     ms 540
717,111,163,274,144610.0,29     ms 18
718,108,167,275,136620.0,290     ms 150
719,109,166,275,138830.0,117     ms 74
720,109,167,276,141570.0,250      80
721,108,169,277,141490.0,11     ms 9
722,109,168,277,142970.0,9      s 6
723,110,167,277,145140.0,6     ms 3
724,112,165,277,152400.0,850     us 280
725,109,169,278,145740.0,7      s 3
726,111,167,278,150520.0,8     ms 5
727,113,165,278,158890.0,2.3   ms 1.3
728,110,169,279,149130.0,210     ms 50
729,111,168,279,151780.0,180     ms 110
730,110,170,280,150520.0,11      s 6
731,111,169,280,153890.0,4.3    s 0.7
732,110,171,281,153430.0,14      s 4
733,111,170,281,155300.0,24      s 8
734,112,169,281,158020.0,180     ms 80
735,111,171,282,157800.0,1.6    m 0.7
736,112,170,282,158980.0,900     us 240
737,113,169,282,163730.0,140     ms 90
738,112,171,283,161490.0,4.1    s 1.0
739,113,170,283,164710.0,160     ms 100
740,112,172,284,162550.0,104     ms 20
741,113,171,284,166590.0,930     ms 140
742,114,170,284,168920.0,3.3   ms 1.4
743,112,173,285,165170.0,32      s 9
744,113,172,285,167730.0,3.3    s 1.1
745,114,171,285,171000.0,210     ms 100
746,113,173,286,170010.0,7      s 3
747,114,172,286,171770.0,140     ms 30
748,114,173,287,174070.0,520     ms 130
749,115,172,287,177900.0,95     ms 60
750,114,174,288,175040.0,750     ms 140
751,115,173,288,179770.0,170     ms 25
752,114,175,289,177560.0,2.4    s 0.6
753,115,174,289,180670.0,310     ms 90
754,115,175,290,182890.0,410     ms 190
755,116,174,290,185200.0,8     ms 3
756,116,175,291,187390.0,28     ms 15
757,116,176,292,188240.0,24     ms 12
758,116,177,293,190670.0,80     ms 40
759,117,176,293,194390.0,21     ms 6
760,117,177,294,196520.0,70     ms 30
761,118,176,294,199460.0,1.15  ms 0.47
